48 48 48 26 39 39 39 39 39 39 39 39 39 39 39 39 19 48 48 48
48 48 26 45 00 00 00 00 14 00 00 00 00 00 00 00 38 19 48 48
48 26 45 00 00 00 00 00 00 00 00 00 00 00 00 00 00 38 19 48
26 45 00 00 00 00 35 00 14 00 00 00 14 00 00 00 00 00 38 19
47 00 00 00 14 00 00 14 00 00 14 00 00 00 00 00 00 00 00 06
47 00 00 00 14 14 00 00 00 00 00 00 00 00 00 00 00 00 00 06
47 00 00 00 00 00 00 00 00 00 00 00 00 00 00 00 00 00 00 06
47 00 00 00 00 00 00 00 00 00 00 00 00 00 00 00 00 00 00 06
47 00 00 00 31 25 24 14 00 00 00 00 00 00 00 14 00 00 00 06
47 00 14 31 13 48 47 00 14 00 00 00 00 00 14 00 00 00 00 06
47 00 31 13 48 26 45 00 00 00 00 00 00 00 00 00 00 00 00 06
20 25 13 48 26 45 00 35 00 00 00 00 00 00 00 14 00 00 31 13
48 48 48 26 45 00 00 00 00 14 00 00 00 00 00 00 00 31 13 48
48 48 48 47 00 00 00 00 00 00 00 00 00 00 00 00 31 13 48 48
48 48 48 20 23 23 23 23 23 23 23 23 23 23 23 23 13 48 48 48
