26 27 27 27 27 27 27 27 27 27 27 27 27 27 27 27 27 27 27 19
47 12 12 12 12 02 12 12 12 36 36 12 12 12 43 12 12 12 12 06
47 00 00 00 00 00 00 17 00 00 00 00 17 00 00 00 00 00 00 06
47 00 00 00 00 00 00 10 00 00 00 00 10 00 00 00 00 00 00 06
47 00 00 00 00 00 22 00 00 00 00 00 00 22 00 00 00 00 00 06
47 00 00 00 00 00 00 00 00 00 00 00 00 00 00 00 00 00 00 06
47 00 00 00 00 00 00 00 22 00 00 22 00 00 00 00 00 00 14 06
47 00 00 00 00 00 00 00 00 00 00 00 00 00 00 00 00 00 14 06
47 00 00 00 00 00 00 00 00 00 00 00 00 00 00 00 00 00 14 06
47 00 00 00 00 00 00 00 00 00 00 00 00 00 00 00 00 00 00 06
47 00 00 00 00 35 00 00 00 00 00 00 00 00 00 00 00 00 00 06
47 00 00 00 00 35 00 00 00 00 00 00 00 00 00 00 00 00 00 06
47 00 00 00 00 00 35 00 00 00 00 00 00 00 00 00 00 00 00 06
47 00 00 00 00 00 00 00 00 00 00 00 00 00 00 00 00 00 00 06
20 25 25 25 25 25 25 25 25 25 25 25 25 25 25 25 25 25 25 13
