26 39 39 39 39 39 39 39 39 39 39 39 39 39 39 39 39 39 39 19
47 12 37 17 37 12 02 12 12 36 46 05 12 43 05 30 17 30 12 06
47 14 00 10 00 00 00 00 00 00 00 00 00 00 00 00 10 00 14 06
20 16 16 16 24 00 35 00 14 07 00 14 14 00 00 00 00 00 00 06
47 43 36 06 47 00 00 14 00 00 14 00 00 31 24 00 00 00 00 06
47 28 28 06 47 14 00 07 00 00 14 00 31 13 20 24 00 14 00 06
47 00 00 06 20 09 09 09 09 24 28 28 06 48 48 47 00 00 00 06
47 07 00 38 27 27 27 27 27 45 21 00 06 26 39 45 00 00 07 06
47 00 00 07 00 14 00 14 00 07 00 00 06 47 12 12 00 00 00 06
47 00 14 00 00 00 00 00 14 00 00 00 06 47 14 35 00 00 00 06
47 00 00 14 31 25 25 25 25 25 25 25 13 20 16 24 00 00 14 06
47 00 00 21 38 34 41 41 41 41 41 41 41 41 34 45 00 00 00 06
47 00 00 00 28 14 07 00 00 14 07 00 00 00 00 00 21 00 00 06
47 00 14 00 00 00 07 00 00 00 00 00 00 00 00 00 14 00 00 06
20 18 18 18 18 18 18 18 18 18 18 18 18 18 18 18 18 18 18 13
