26 39 39 39 39 39 39 39 39 39 39 39 39 39 39 39 39 39 39 19
47 12 12 12 12 12 12 12 12 12 12 12 12 12 12 12 12 12 12 06
47 14 00 00 00 00 00 00 42 00 00 00 00 00 00 00 00 00 00 06
47 00 00 00 00 00 31 18 18 18 18 18 18 18 18 18 24 00 00 06
47 00 00 01 14 00 38 34 34 34 34 34 34 34 19 26 45 00 00 06
47 00 00 00 14 14 46 36 12 17 12 43 12 17 06 47 12 00 00 06
47 00 14 00 00 00 00 00 00 10 00 14 00 10 06 47 00 01 00 06
47 00 00 00 00 00 00 00 14 00 00 00 00 00 06 47 00 14 00 06
47 00 00 31 16 16 16 16 16 16 16 24 14 31 13 47 00 00 14 06
47 00 14 38 27 27 19 48 26 27 27 45 28 38 27 45 00 00 00 06
47 00 00 46 30 30 06 48 47 43 30 12 21 30 30 12 00 35 21 06
47 00 00 00 00 00 38 41 45 00 00 00 00 00 00 14 00 00 00 06
47 00 42 00 00 00 30 37 12 14 00 00 00 00 00 35 00 00 14 06
47 00 00 00 00 00 00 00 00 00 00 42 00 00 00 00 00 00 00 06
20 23 23 23 23 23 23 23 23 23 23 23 23 23 23 23 23 23 23 13
