26 39 39 39 39 39 39 39 39 39 39 39 39 39 39 39 39 39 39 48
47 43 37 43 37 43 37 37 37 37 37 37 37 37 37 36 37 36 11 48
47 14 00 00 00 00 30 00 00 00 00 00 00 30 00 00 00 00 03 48
47 00 00 00 00 00 17 00 14 00 30 00 14 17 00 00 08 00 03 48
47 00 00 00 14 00 10 14 00 00 30 00 00 10 00 00 00 00 03 48
47 00 00 00 14 14 00 00 00 00 30 00 00 00 00 00 00 00 03 48
47 30 30 30 30 00 30 37 02 46 46 46 02 37 37 30 30 00 03 48
47 00 00 00 00 00 30 00 00 00 00 00 00 00 00 00 00 00 03 48
47 00 31 18 24 14 30 14 05 05 05 05 05 46 37 14 30 30 03 48
47 00 06 48 47 00 30 00 46 00 00 00 00 46 00 00 00 00 03 48
47 00 06 48 47 00 17 00 46 00 46 00 00 17 00 46 46 00 03 48
47 00 38 41 45 00 10 00 46 00 46 00 00 10 00 30 30 00 03 48
47 00 00 00 00 00 00 00 46 14 46 00 00 00 00 00 00 00 03 48
47 46 46 46 46 46 46 37 00 00 00 37 37 37 46 46 46 46 03 48
20 23 23 23 23 23 16 25 24 00 31 25 25 25 23 23 23 23 09 48
