26 34 34 34 34 34 34 34 34 34 34 34 34 34 34 34 34 34 34 19
47 12 02 12 12 17 12 02 12 12 17 12 02 12 12 17 12 02 12 06
47 00 00 00 00 10 00 00 00 00 10 00 00 00 00 10 00 00 00 06
47 00 00 00 00 00 00 00 00 00 00 00 00 00 00 00 00 00 00 06
47 00 00 00 31 25 25 25 25 25 24 22 00 00 00 00 00 00 00 06
45 00 00 00 06 26 39 39 39 19 47 22 00 00 00 00 00 00 00 06
12 00 00 00 06 47 05 05 05 38 45 22 00 00 00 00 00 00 00 06
00 00 00 00 06 47 08 22 00 00 00 00 00 00 00 00 00 00 00 06
00 00 00 00 06 47 00 00 00 31 24 22 00 00 00 00 00 00 00 06
00 00 00 00 06 20 18 18 18 13 47 22 00 00 00 00 00 00 00 06
11 00 00 00 38 39 39 39 39 39 45 22 00 00 00 00 00 00 00 06
47 00 00 00 00 00 00 00 00 00 00 00 00 00 00 00 00 00 00 06
47 00 00 00 00 00 00 00 00 00 00 00 00 00 00 00 00 00 00 06
47 00 00 00 00 00 00 00 00 00 00 00 00 00 00 00 00 00 00 06
20 18 23 23 23 23 23 23 23 23 23 23 23 23 23 23 23 23 18 13
