26 34 34 34 34 34 34 34 34 34 34 34 34 34 34 34 34 34 34 19
47 12 02 12 12 17 12 02 12 12 17 12 02 12 12 17 12 02 12 06
47 00 00 00 00 10 00 00 00 00 10 00 00 00 00 10 00 00 00 06
47 00 00 00 00 00 00 00 00 00 00 00 00 00 00 00 00 00 00 06
47 00 00 00 31 25 25 25 25 25 24 00 00 00 00 00 00 00 00 06
47 00 00 00 06 26 39 39 39 41 45 00 00 00 00 00 00 00 00 06
47 00 00 00 06 47 05 05 05 05 05 00 00 00 00 00 00 00 00 06
47 00 00 00 06 47 00 00 00 00 00 00 00 00 00 00 00 00 00 06
47 00 00 00 06 47 00 00 00 07 00 00 00 00 00 00 00 00 00 06
47 00 00 00 06 20 18 18 18 25 24 00 00 00 00 00 00 00 00 06
47 00 00 00 38 39 39 39 39 39 45 00 00 00 00 00 00 00 00 06
47 00 00 00 30 02 30 17 30 02 30 00 00 00 00 00 00 00 00 06
47 00 00 00 00 00 00 00 00 00 00 00 00 00 00 00 00 00 00 06
47 00 00 00 00 00 00 00 00 00 00 00 00 00 00 00 00 00 00 06
20 18 23 23 23 23 23 23 23 23 23 23 23 23 23 23 23 23 18 13
