00 00 09 00 00 00 00 00 00 00 09 00 00 00 00 00 00 00 00 00
00 00 00 00 00 09 00 00 09 00 00 00 00 00 00 09 09 00 00 00
00 09 00 00 00 00 00 00 00 00 00 09 00 00 00 00 00 00 00 00
00 00 09 00 09 00 09 00 00 00 00 00 00 00 00 09 00 09 09 00
00 00 00 00 00 00 00 00 00 09 00 09 00 00 00 00 00 00 00 00
00 09 00 00 00 00 00 00 00 00 00 00 00 00 00 00 00 00 00 00
00 00 00 00 30 00 00 09 00 00 00 09 00 02 00 00 09 00 00 00
00 00 09 00 30 00 00 00 00 00 00 00 00 26 00 00 09 00 00 00
00 00 00 00 30 00 00 00 00 00 09 00 00 02 00 00 00 00 00 00
00 00 09 00 06 00 00 09 00 00 00 00 00 26 00 00 09 09 00 00
00 09 00 00 06 00 00 09 00 00 09 00 00 02 00 09 00 00 00 00
00 00 00 00 06 00 00 00 00 00 00 09 00 02 00 00 00 00 09 00
00 00 09 00 00 00 00 09 00 00 00 00 00 02 00 00 00 00 00 00
00 00 00 09 00 09 00 09 00 00 09 00 00 09 00 00 09 00 09 00
00 00 00 09 00 00 00 00 00 00 00 00 00 00 00 00 00 00 00 00
