26 34 34 34 34 34 34 34 34 34 34 34 34 34 34 34 34 34 34 19
47 00 00 35 00 00 00 00 00 00 00 00 00 00 00 00 00 00 00 06
47 00 00 00 00 00 00 00 00 00 00 00 00 00 00 00 00 00 00 06
47 00 00 00 00 00 00 00 00 00 00 00 00 00 00 00 00 00 00 06
47 00 46 36 46 00 00 00 28 31 25 24 00 00 00 00 00 00 00 06
47 00 00 46 00 00 00 00 00 06 48 47 00 00 00 00 00 00 00 06
47 00 01 43 00 00 00 00 00 06 26 45 00 00 01 00 00 00 00 06
47 00 00 46 00 00 08 00 00 06 47 00 00 00 00 00 00 00 00 06
47 00 00 46 00 00 00 00 00 38 45 00 00 00 00 00 00 00 00 06
47 00 00 00 00 00 00 00 00 00 00 00 00 00 00 00 00 00 00 06
47 00 00 00 28 00 28 00 00 00 00 00 35 00 00 00 00 00 00 06
47 00 00 35 00 00 00 00 00 00 00 00 00 00 00 00 00 00 00 06
47 00 00 00 00 00 00 00 00 01 00 00 00 00 00 00 00 00 00 06
47 00 00 00 00 00 00 00 00 00 00 00 00 00 00 00 00 00 00 06
20 23 23 23 23 23 23 23 23 23 23 23 23 23 23 23 23 23 23 13
