23 34 34 34 34 34 34 34 34 34 34 34 34 34 34 34 34 34 34 27
06 00 00 00 00 00 00 00 00 00 00 00 00 00 00 00 00 00 00 02
06 00 00 20 00 00 00 00 00 00 08 00 24 00 00 00 24 00 00 02
06 00 20 00 00 00 00 00 00 00 00 00 00 00 00 00 00 00 00 02
06 08 00 32 00 04 04 04 28 04 04 04 00 00 00 24 00 00 00 02
06 00 00 00 00 00 04 00 00 04 17 04 00 00 00 24 00 00 00 02
06 08 00 00 00 00 04 00 00 04 04 04 00 00 00 00 00 00 00 02
06 00 13 08 00 00 04 08 00 04 04 00 00 00 00 24 00 00 08 02
06 00 00 08 00 00 04 00 00 04 00 04 00 00 00 00 00 00 08 02
06 00 13 00 00 00 00 00 00 00 00 00 00 00 00 00 00 00 08 02
06 00 00 00 28 00 28 00 00 00 00 00 00 00 00 00 00 00 00 02
06 00 00 00 00 00 08 00 08 08 00 00 00 24 00 00 01 00 00 02
06 00 00 00 00 00 00 00 00 00 00 00 00 00 00 00 00 00 00 02
06 00 00 00 00 00 00 00 00 00 00 00 00 00 00 00 00 00 00 02
12 19 19 19 19 19 19 19 19 19 19 19 19 19 19 19 19 19 19 16
