26 39 39 39 39 39 39 39 39 39 39 39 39 39 39 39 39 39 39 19
47 00 00 00 00 00 00 00 14 00 00 00 00 00 00 00 00 00 00 06
47 14 00 00 00 00 00 00 00 00 00 00 00 00 00 31 16 24 00 06
47 00 00 00 00 00 35 00 14 00 00 00 14 00 00 06 48 47 00 06
47 00 00 00 14 00 00 14 00 00 14 00 00 00 00 38 34 45 00 06
47 00 00 00 14 14 00 00 00 00 00 00 00 00 00 00 00 00 00 06
47 00 00 00 00 00 00 00 00 00 00 00 00 00 00 00 00 00 00 06
47 00 00 00 00 00 00 00 00 00 00 00 00 00 00 00 00 00 00 06
47 00 00 00 00 14 00 14 00 00 00 00 00 00 00 14 00 00 00 06
47 00 14 00 00 00 00 00 14 00 00 00 00 00 14 00 00 00 00 06
47 00 00 00 00 00 00 00 00 00 00 00 00 00 00 00 00 00 00 06
47 00 00 00 00 00 00 35 00 00 00 00 00 00 00 14 00 00 00 06
47 00 00 00 00 00 00 00 00 14 00 00 00 00 00 00 00 00 00 06
47 00 00 00 00 00 00 00 00 00 00 00 00 00 00 00 00 00 00 06
20 23 23 23 23 23 23 23 23 23 23 23 23 23 23 23 23 23 23 13
