26 39 39 39 39 39 39 39 39 39 39 39 39 39 39 39 39 39 39 19
47 00 00 00 00 00 00 00 14 00 00 00 00 00 00 00 00 00 00 06
47 14 00 00 00 00 00 00 00 00 00 00 00 00 00 00 00 00 00 06
47 00 31 25 25 24 35 00 14 00 00 00 14 00 31 25 25 24 00 06
47 00 06 43 43 47 00 14 00 00 14 00 00 00 06 43 43 47 00 06
47 00 38 39 39 45 00 00 00 00 00 00 00 00 38 32 32 45 00 06
47 00 00 00 00 00 00 00 00 00 00 00 00 00 00 00 00 00 00 06
47 00 00 00 00 00 00 00 00 00 00 00 00 00 00 00 00 00 00 06
47 00 00 00 00 14 00 14 00 00 00 00 00 00 00 14 00 00 00 06
47 00 00 00 00 00 00 00 14 00 00 00 00 00 14 00 00 00 00 06
20 23 23 23 23 23 23 04 00 00 00 00 11 23 23 23 23 23 23 13
48 26 39 39 39 19 48 04 00 00 00 00 11 48 26 39 39 39 19 48
48 47 07 17 14 06 48 04 00 14 00 00 11 48 47 14 17 07 06 48
48 47 14 10 07 06 48 04 00 00 00 00 11 48 47 07 10 14 06 48
48 20 23 23 23 13 48 23 18 18 18 18 18 48 20 23 23 23 13 48
