26 41 41 41 41 41 41 45 00 00 00 38 41 41 41 41 41 41 41 19
47 12 12 12 12 12 12 12 00 00 00 12 12 12 12 12 12 12 12 06
47 00 00 00 00 00 00 00 00 00 00 00 00 00 00 00 00 00 00 06
47 00 00 00 00 00 00 00 00 00 00 00 00 00 00 00 00 00 00 06
47 00 00 00 00 00 00 00 00 00 00 00 00 00 00 00 00 00 00 06
45 00 00 00 00 00 00 00 00 00 00 00 00 00 00 00 00 00 00 38
12 00 00 00 00 00 00 00 00 00 00 00 00 00 00 00 00 00 00 05
00 00 00 00 00 00 00 00 00 00 00 00 00 00 00 00 00 00 00 00
00 00 00 00 00 00 00 00 00 00 00 00 00 00 00 00 00 00 00 00
00 00 00 00 00 00 00 00 00 00 00 00 00 00 00 00 00 00 00 00
03 00 00 00 00 00 00 00 00 00 00 00 00 00 00 00 00 00 00 04
47 00 00 00 00 00 00 00 00 00 00 00 00 00 00 00 00 00 00 06
47 00 00 00 00 00 00 00 00 00 00 00 00 00 00 00 00 00 00 06
47 00 00 00 00 00 00 00 00 00 00 00 00 00 00 00 00 00 00 06
20 16 16 16 16 16 16 24 00 00 00 31 16 16 16 16 16 16 16 13
