23 34 34 34 34 34 34 34 34 34 34 34 34 34 34 34 34 34 34 27
06 00 00 00 00 00 00 00 00 00 00 00 00 00 00 00 00 00 00 02
06 00 00 00 00 00 00 00 00 00 00 00 00 00 00 00 00 00 00 02
06 04 00 00 00 00 00 00 00 00 00 00 00 04 08 04 00 00 00 02
06 00 00 00 00 00 00 00 00 08 00 00 00 00 18 22 00 00 00 02
06 00 00 00 04 00 00 00 00 00 00 04 00 08 18 22 00 00 00 02
06 00 00 00 00 00 13 13 13 00 13 13 13 00 00 00 00 00 00 02
06 04 00 08 00 00 00 17 00 00 00 17 00 00 00 00 00 00 00 02
06 00 00 00 00 00 17 00 17 00 17 00 17 00 00 00 00 00 00 02
06 00 00 00 00 00 00 17 04 00 00 17 00 00 00 00 00 00 00 02
06 00 00 08 00 00 00 00 00 05 00 08 00 00 00 00 00 00 00 02
06 00 00 00 00 17 00 00 00 00 00 00 00 17 00 00 00 00 00 02
06 00 04 00 00 00 17 17 17 17 17 17 17 00 00 00 00 00 00 02
06 00 00 00 00 00 00 05 05 05 05 05 00 00 00 00 00 00 00 02
12 19 19 19 19 19 19 19 19 19 19 19 19 19 19 19 19 19 19 16
