23 34 34 34 34 34 34 34 34 34 34 34 34 34 34 34 34 34 34 27
06 00 00 00 00 00 00 00 00 00 00 00 00 00 00 00 00 00 00 02
06 00 00 00 00 00 00 00 00 00 00 00 00 00 00 00 00 00 00 02
06 04 00 00 00 00 00 00 00 00 00 00 00 04 08 04 00 00 00 02
06 00 00 26 00 00 00 00 00 08 00 00 00 00 00 00 00 00 00 02
06 00 00 00 04 00 00 00 00 00 00 04 00 08 08 08 00 00 00 02
06 00 26 00 00 00 00 32 00 00 00 00 08 00 00 00 00 00 00 02
06 04 00 08 00 00 00 00 00 00 00 17 00 00 00 00 00 00 00 02
06 00 26 00 00 00 00 00 00 00 17 00 00 00 00 00 00 00 00 02
06 00 00 00 00 00 00 17 04 00 00 17 00 00 00 00 00 00 00 02
06 00 00 08 00 00 00 00 17 00 00 08 00 00 00 00 00 00 00 02
06 00 00 26 00 00 00 00 00 00 00 00 00 00 00 00 00 00 00 02
06 00 04 00 00 00 00 00 00 00 00 00 00 00 00 00 00 00 00 02
06 00 00 00 00 00 00 00 00 00 08 00 00 00 00 00 00 00 00 02
12 19 19 19 19 19 19 19 19 19 19 19 19 19 19 19 19 19 19 16
