23 34 34 34 34 34 34 34 34 34 34 34 34 34 34 34 34 34 34 27
06 00 00 00 00 00 00 00 00 00 00 00 00 00 00 00 00 00 00 02
06 00 00 00 00 00 00 00 00 00 00 00 00 00 00 00 00 00 00 02
06 00 00 00 04 04 04 04 00 00 00 00 00 04 04 04 04 04 04 02
06 00 00 32 04 00 00 04 04 00 00 00 00 04 00 00 00 00 00 02
06 00 00 00 04 00 00 04 04 00 00 00 00 04 00 00 00 00 00 02
06 00 00 00 04 04 04 04 00 00 00 00 00 04 00 00 00 00 00 02
06 00 00 00 04 04 00 00 00 00 00 00 00 04 04 04 04 00 00 02
06 00 00 00 04 00 04 00 00 00 00 00 00 04 00 00 00 00 00 02
06 00 00 00 04 00 04 00 00 00 00 00 00 04 00 00 00 00 00 02
06 00 00 00 04 00 00 04 04 00 00 00 00 04 00 00 00 00 00 02
06 00 00 00 00 00 00 00 00 00 00 00 00 00 00 00 00 00 00 02
06 00 00 00 00 00 00 00 00 00 00 00 00 00 00 00 00 00 00 02
06 00 00 00 00 00 00 00 00 00 00 00 00 00 00 00 00 00 00 02
12 19 19 19 19 19 19 19 19 19 19 19 19 19 19 19 19 19 19 16
