26 34 34 34 34 34 34 34 34 34 34 34 34 34 34 34 34 34 41 19
47 00 00 00 00 00 00 00 00 00 00 00 00 00 00 46 00 00 00 06
47 00 00 00 00 00 00 00 00 00 00 00 00 00 00 43 46 00 00 06
47 00 00 00 00 00 00 00 00 01 00 00 00 00 00 00 17 46 00 06
47 00 00 00 00 15 15 15 00 00 00 15 15 15 15 00 00 46 17 06
47 00 29 00 00 15 00 15 00 00 00 15 00 00 00 00 00 00 00 06
47 00 00 00 00 15 15 15 00 00 00 15 15 15 00 00 00 00 00 06
47 00 00 00 00 15 15 00 00 00 00 15 00 00 00 00 00 00 00 06
47 00 00 00 00 15 00 15 00 00 00 15 00 00 00 00 00 00 00 06
47 00 00 00 00 15 00 15 00 00 00 15 00 00 00 00 00 29 00 06
47 00 00 00 00 00 00 00 00 00 00 00 00 00 00 00 00 00 00 06
47 00 00 00 00 00 00 00 00 00 00 00 00 00 00 00 00 00 00 06
47 00 00 00 00 01 00 00 00 00 00 00 00 01 00 00 00 00 00 06
47 00 00 00 00 00 00 00 00 00 00 00 00 00 00 00 00 00 00 06
20 25 25 25 25 25 25 25 25 25 25 25 25 25 25 25 25 25 25 13
