26 34 34 34 34 34 34 34 34 34 34 34 34 34 34 34 34 34 34 19
47 00 00 00 00 00 00 00 00 00 00 00 00 00 00 00 00 00 00 06
47 00 00 00 00 00 00 00 00 00 00 00 00 00 00 00 00 00 00 06
47 00 00 00 04 04 04 04 00 00 00 00 00 04 04 04 04 04 00 06
47 00 00 00 04 00 00 04 04 00 00 00 00 04 00 00 00 00 00 06
47 00 00 00 04 00 00 04 04 00 00 00 00 04 00 00 00 00 00 06
47 00 00 00 04 04 04 04 00 00 00 00 00 04 00 00 00 00 00 06
47 00 00 00 04 04 00 00 00 00 00 00 00 04 04 04 04 00 00 06
47 00 00 00 04 00 04 00 00 00 00 00 00 04 00 00 00 00 00 06
47 00 00 00 04 00 04 00 00 00 00 00 00 04 00 00 00 00 00 06
47 00 00 00 04 00 00 04 04 00 00 00 00 04 00 00 00 00 00 06
47 00 00 00 00 00 00 00 00 00 00 00 00 00 00 00 00 00 00 06
47 00 00 00 00 00 00 00 00 00 00 00 00 00 00 00 00 00 00 06
47 00 00 00 00 00 00 00 00 00 00 00 00 00 00 00 00 00 00 06
20 16 16 16 16 16 16 16 16 16 16 16 16 16 16 16 16 16 16 13
